00000000000000000000
00000000000000000000
00000000000000000000
00000000000000000000
00000000000001111110
00000000000110000001
00000000111111110001
00000000101000010000
00000000101000110000
00000000101111100000
00000000111000000000
00000000001000000000
00000000000000000000
